1111111111111111111111111111111111
1000000000000000000000000000000001
1000000000000000000000000000000001
1000000000000011100000000000000001
100000000000001N100000000000000001
1000000000000011100000000000000001
1000000010000000000001000000000001
1000000010000000000001000000000001
1000000010000000000001000000000001
1000000010000000000001000000000001
1111111111111111111111111111111111