11111111111111111111111111111111111111111111111111111111111111111111111111 
11111111100000000011000000000000111111111100000000110000010000000111111111 
11111111101100000111000000000000111111111100000N00111000001000000111111111 
11111111100100000000000000000000111111111100000000000000000000000111111111 
11111111101100000101000001000000111111111101100011101000001000000111111111 
10000000001100000111110111111111111110000000001100000111111111111111111111 
11110111111111111100000010001111101111010110110000000100011111111111111111 
11110111111111011101010000001111101111111110110010100000011111111111111111 
11000000110101011110000010000000000001101010111100000100011111111111111111 
10000000100000001100000100011110000000100000001000000100011111111111111111 
10000000000000001101010010001100000000000000011010100100011111111111111111 
11000001110101011111111110011100000111010101111101111001111111111111111111 
11111111110100000000000111111111111111011111000000011011111111111111111111 
11111111110111111111110111111111111111011111111111111011111111111111111111 
10000000000000000000000011111111111100000000011000001000000111111111111111 
10110000011100000000000011111111111011000001110000010000001111111111111111 
10010000000000000000000011111111111100100000000000000000001111111111111111 
11111111101100000101000000000000111111111101110000101000001000000111111111 
10000000001100000111110111111111110000000001100000111110111111111111111111 
11110111111111111100000010001111100111111111011100000010001111111111111111 
11110111111111011101010000001111101111111110111010100000011111111111111111 
11000000110101011110000010001110000001101010111100000100011111111111111111 
10000000100000001100001000000000000001000000011000001000111111111111111111 
10000000000000001101010010001100000000000000011010100100011111111111111111 
11000001110101011111011110011100000111010101111101111001111111111111111111 
11111111110111111111111111111111111111011111111111111111111111111111111111 
11111111111111111111111111111111111111111111111111111111111111111111111111