1111111111111111111111111111111111111111111111
1000000000000000000000000000000000000000000001
1001111111111111111111111111111111111111111001
1001000000000000000000000000000000000000001001
1001000000000000000000000000000000000000001001
1001000000000000000000000000000000000000001001
1001000000000000000000000000000000000000001001
1001000000000000000000000000000000000000001001
1001000000000000000000000000000000000000001001
1001000000000000000000N00000000000000000001001
1001000000000000000001010000000000000000001001
1001000000000000000001010000000000000000001001
1001000000000000000001010000000000000000001001
1001000000000000000001010000000000000000001001
1001000000000000000001010000000000000000001001
1001000000000000000001011111111111111111111001
1001000000000000000001000000000000000000000001
1111111111111111111111111111111111111111111111